NO ./textures/north.png
SO ./textures/south.png
WE ./textures/west.png
EA ./textures/east.png

F 220,100,100
C 225,30,20

        1111111111111111111111111
        1000000000000001200000021
        1011000000000000111112111
        1001000000000001000000001
1111111110110000011100000N0000001
100000000011000001110111100111111
11110111111111011100000010021
11110111111111011101010010001
11000000110101011100020010001
10000000000000001100000010001
10000000000000001101010000001
110000011101010111110111000111
11110111 1110101 101111012001
11111111 1111111 111111111111