NO ./textures/north.png
SO ./textures/south.png
WE ./textures/west.png
EA ./textures/east.png

F 220,100,100
C 225,30,20

111111111111111111111111
10000000000000020N000021
1011000000000001111112111
11111111111111111111 1111
