NO ./textures/north.png
SO ./textures/south.png
WE ./textures/west.png
EA ./textures/east.png

F 220,100,100
C 225,30,20

111111111111111111111111
10000000000000000N000001
111111111111111111111111
