121
N1111
11111
11111
emptyLine!

10111
N1111
11111
11111
emptyLine!


1
N1111
11111
11111