C 3,10,15
NO ./textures/north.png
SO ./textures/south.png
EA ./textures/east.png
WE ./textures/west.png



F 50,5,5

1111111111111111111111111
1000000000110000000000001
1011000001110000000000001
100100000022000000000000111111111
1111121110110000011100000000000011
100000000011000001110111111111111
11110111111111011100000010001
11110111111111011101010010001
11000000110101011100000010001
10000000100000001100000020001
10000000200000001101010010001
11000001110101011111011110S0111
11110111 1110101 10111101000111
11111111 1111111 11111111111111
