NO ./textures/north.png
SO ./textures/south.png
EA ./textures/east.png
WE ./textures/west.png



C 15,10,70
F 50,12 ,103   

1111111111111111111111111
1000000000110000000000001
1011000001110000000000001
100100000022000000000000111111111
111112111011000001110000000000001     1
100000000011000001110111111111111
11110111111111011100000010001
11110111111111011101010010001
11000000110101011100000010001
10000000100000001100000020001
10000000200000001101010010001
11000001110101011111011110S0111
11110111 1110101 10111101000111
1111111111111111111111111111111
