NO ./textures/north.png
SO ./textures/south.png
WE ./textures/west.png
EA ./textures/east.png



F 128,128,128
C 0,102,102


        1111111111111111111111111
        1000000000120000000000021
        1011000001111111211111111
        1001000000000000000000001
11111111101100000111000N000000001
100000000011000001110111100111111
11110111111111011100000010001
11110111111111011101010010001
11000000110101011100000010001
10000000000000001100000010001
10000000000000001101010000001
1100000111010101111101110000111
11110111 1110101 101111010001
11111111 1111111 111111111111